R 480 480

NO ./textures/wood.xpm
SO ./textures/bricks.xpm
WE ./textures/wall.xpm
EA ./textures/marmol.xpm

S  ./textures/barrel.xpm

F 0,255,0
C 0,0,255

11111111111111111111111111111111111111
100000000000N000000000000000000020111111
10000020000100000022200000122220000001
10000000200220200000020000022000000001
10000020000000021111111111111111111111
10000000000020001
100002000200200011111110
10002000021000001
11111100000111111
    100000001
    100000001
    111111111